{

  "LEVEL_0": [ [000,000,000,000,000,000,000,000,000,000,000,000,000,000],
               [000,100,200,100,200,100,200,100,200,100,200,100,200,000],
			   [000,200,100,200,100,200,100,200,100,200,100,200,100,000],
               [000,100,200,100,200,100,200,100,200,100,200,100,200,000],
			   [000,200,100,200,100,200,100,200,100,200,100,200,100,000],
               [000,100,200,100,200,100,200,100,200,100,200,100,200,000],
			   [000,200,100,200,100,200,100,200,100,200,100,200,100,000],
               [000,100,200,100,200,100,200,100,200,100,200,100,200,000],
               [000,200,100,200,100,200,100,200,100,200,100,200,100,000],
               [000,000,000,000,000,000,000,000,000,000,000,000,000,000], 

			   [000,000,000,000,000,000,000,000,000,000,000,000,000,000],
               [000,000,000,000,000,000,000,000,000,000,000,000,000,000],
			   [000,000,000,000,000,000,000,000,000,000,000,000,000,000],
               [000,000,000,000,000,000,000,000,000,000,000,000,000,000],
			   [000,000,000,000,000,000,000,000,000,000,000,000,000,000],
               [000,000,000,000,000,000,000,000,000,000,000,000,000,000],
			   [000,000,000,000,000,000,000,000,000,000,000,000,000,000],
               [000,000,000,000,000,000,000,000,000,000,000,000,000,000],
               [000,000,000,000,000,000,000,000,000,000,000,000,000,000],
               [000,000,000,000,000,000,000,000,000,000,000,000,000,000], 
			   
			   [400,400,400,400,400,400,400,400,400,400,400,400,400,400],
               [400,000,000,000,000,000,000,000,000,000,000,000,000,400],
			   [400,000,000,000,000,000,000,000,000,000,000,000,000,400],
               [400,000,000,000,000,000,000,000,000,000,000,000,000,400],
			   [400,000,000,000,000,000,000,000,000,000,000,000,000,400],
               [400,000,000,000,000,000,000,000,000,000,000,000,000,400],
			   [400,000,000,000,000,000,000,000,000,000,000,000,000,400],
               [400,000,000,000,000,000,000,000,000,000,000,000,000,400],
               [400,000,000,000,000,000,000,000,000,000,000,000,000,400],
               [400,400,400,400,400,400,400,400,400,400,400,400,400,400] ],

  "LEVEL_1": [ [000,000,000,000,000,000,000,000,000,000,000,000,000,000],
               [000,100,200,100,200,150,150,100,200,100,200,100,200,000],
			   [000,200,100,200,100,200,100,200,100,200,100,200,100,000],
               [000,100,200,100,200,100,200,100,200,100,200,100,200,000],
			   [000,200,100,200,100,200,100,200,100,200,100,200,100,000],
               [000,100,200,100,200,100,200,100,200,100,200,100,200,000],
			   [000,200,100,200,100,200,100,200,100,200,100,200,100,000],
               [000,100,200,100,200,100,200,100,200,100,200,100,200,000],
               [000,200,100,200,100,200,100,200,100,200,100,200,100,000],
               [000,000,000,000,000,000,000,000,000,000,000,000,000,000], 

			   [000,000,000,000,000,000,000,000,000,000,000,000,000,000],
               [000,000,000,000,000,000,000,000,000,000,000,000,000,000],
			   [000,000,000,000,000,000,000,000,000,000,000,000,000,000],
               [000,000,000,000,000,000,000,000,000,000,000,000,000,000],
			   [000,000,000,000,000,000,000,000,000,000,000,000,000,000],
               [000,000,000,000,000,000,000,000,000,000,000,000,000,000],
			   [000,000,000,000,000,000,000,000,000,000,000,000,000,000],
               [000,000,000,000,000,000,000,000,000,000,000,000,000,000],
               [000,000,000,000,000,000,000,000,000,000,000,000,000,000],
               [000,000,000,000,000,000,000,000,000,000,000,000,000,000], 
			   
			   [400,400,400,400,400,400,400,400,400,400,450,451,400,400],
               [400,000,000,000,000,000,000,000,000,000,000,000,000,400],
			   [400,000,000,000,000,000,000,000,000,000,000,000,000,400],
               [400,000,000,000,000,000,000,000,000,000,000,000,000,400],
			   [400,000,000,000,000,000,000,000,000,000,000,000,000,400],
               [400,000,000,000,000,000,000,000,000,000,000,000,000,400],
			   [400,000,000,000,000,300,300,000,000,000,000,000,000,400],
               [400,000,000,000,000,000,000,000,000,000,000,000,000,400],
               [400,000,000,000,000,000,000,000,000,000,000,000,000,400],
               [400,400,400,400,400,400,400,400,400,400,400,400,400,400] ],
			   
  "LEVEL_2": [ [000,000,000,000,000,000,000,000,000,000,000,000,000,000],
               [000,100,200,100,200,100,200,100,200,100,200,100,050,000],
               [000,200,100,200,100,200,100,200,100,200,100,200,100,000],
               [000,100,200,100,200,100,200,100,200,100,200,100,200,000],
               [000,200,100,200,100,200,100,200,100,200,100,200,100,000],
               [000,100,200,100,200,100,200,100,200,100,200,100,200,000],
               [000,200,100,200,100,200,100,200,100,200,100,200,100,000],
               [000,100,200,100,200,100,200,100,200,100,200,100,200,000],
               [000,200,050,200,100,200,100,200,100,200,100,050,100,000],
               [000,000,000,000,000,000,000,000,000,000,000,000,000,000],

			   [000,000,000,000,000,000,000,000,000,000,000,000,000,000],
               [000,000,000,000,000,000,000,000,000,000,000,000,000,000],
			   [000,000,000,000,000,000,000,000,000,000,000,000,000,000],
               [000,000,000,000,000,000,000,000,000,000,000,000,000,000],
			   [000,000,000,000,000,000,000,000,000,000,000,000,000,000],
               [000,000,000,000,000,000,000,000,000,000,000,000,000,000],
			   [000,000,000,000,000,000,000,000,000,000,000,000,000,000],
               [000,000,000,000,000,000,000,000,000,000,000,000,000,000],
               [000,000,000,000,000,000,000,000,000,000,000,000,000,000],
               [000,000,000,000,000,000,000,000,000,000,000,000,000,000], 
			   
			   [400,400,400,400,400,400,400,400,400,400,400,450,451,400],
               [400,000,000,300,000,000,000,000,000,000,000,000,000,400],
			   [400,000,000,000,000,000,000,000,000,000,000,000,000,400],
               [400,000,000,000,000,000,000,000,000,000,000,000,000,400],
			   [400,000,000,000,000,000,000,000,000,000,000,000,000,400],
               [400,000,000,000,000,300,000,000,000,000,000,000,000,400],
			   [400,000,000,000,000,000,000,000,000,000,000,000,000,400],
               [400,000,000,000,000,000,000,000,000,000,000,000,000,400],
               [400,000,000,000,000,000,000,000,000,000,000,000,300,400],
               [400,400,400,400,400,400,400,400,400,400,400,400,400,400] ],
			   
	"LEVEL_3": [ [000,000,000,000,000,000,000,000,000,000,000,000,000,000],
               [000,100,200,100,050,100,200,100,200,100,200,100,200,000],
			   [000,200,100,200,100,200,100,200,100,200,100,200,100,000],
               [000,100,200,100,200,100,200,100,200,100,200,100,200,000],
			   [000,200,100,200,100,200,100,200,100,200,100,200,100,000],
               [000,100,200,100,200,100,200,100,200,100,200,100,200,000],
			   [000,200,100,200,100,200,100,200,100,200,100,200,100,000],
               [000,100,200,100,200,100,200,100,200,100,200,100,200,000],
               [000,200,100,200,100,200,100,200,100,200,100,200,100,000],
               [000,000,000,000,000,000,000,000,000,000,000,000,000,000], 

			   [000,000,000,000,000,000,000,000,000,000,000,000,000,000],
               [000,000,000,000,000,000,000,000,000,000,000,000,000,000],
			   [000,000,000,000,000,000,000,000,000,000,000,000,000,000],
               [000,000,000,000,000,000,000,000,000,000,000,000,000,000],
			   [000,000,000,000,000,000,000,000,000,000,000,000,000,000],
               [000,000,000,000,000,000,000,000,000,000,000,000,000,000],
			   [000,000,000,000,000,000,000,000,000,000,000,000,000,000],
               [000,000,000,000,000,000,000,000,000,000,000,000,000,000],
               [000,000,000,000,000,000,000,000,000,000,000,000,000,000],
               [000,000,000,000,000,000,000,000,000,000,000,000,000,000], 
			   
			   [400,400,400,400,400,400,400,400,400,400,400,400,400,400],
               [400,000,000,000,000,000,000,000,000,000,000,000,000,400],
			   [400,000,000,000,000,000,000,000,000,000,000,000,000,400],
               [400,000,000,000,000,000,000,000,000,000,000,000,000,400],
			   [400,000,000,000,000,000,000,000,000,000,000,000,000,400],
               [400,000,000,000,000,000,000,000,000,000,000,000,000,400],
			   [400,000,000,000,000,000,000,000,000,000,000,000,000,400],
               [400,000,000,000,000,000,000,000,000,000,000,000,000,400],
               [400,000,000,000,000,000,000,000,000,000,000,000,000,400],
               [400,400,400,400,400,400,400,400,400,400,400,400,400,400] ],
			   
  "LEVEL_4": [ [000,000,000,000,000,000,000,000,000,000,000,000,000,000],
               [000,100,200,100,200,100,200,100,200,100,200,100,200,000],
			   [000,200,100,200,100,200,100,200,100,200,100,200,100,000],
               [000,100,200,100,200,100,200,100,200,100,200,100,200,000],
			   [000,200,100,200,100,200,100,200,100,200,100,200,100,000],
               [000,100,200,100,200,100,200,100,200,100,200,100,200,000],
			   [000,200,100,200,100,200,100,200,100,200,100,200,100,000],
               [000,100,200,100,200,100,200,100,200,100,200,100,200,000],
               [000,200,100,200,100,200,100,200,100,200,100,200,100,000],
               [000,000,000,000,000,000,000,000,000,000,000,000,000,000], 

			   [000,000,000,000,000,000,000,000,000,000,000,000,000,000],
               [000,000,000,000,000,000,000,000,000,000,000,000,000,000],
			   [000,000,000,000,000,000,000,000,000,000,000,000,000,000],
               [000,000,000,000,000,000,000,000,000,000,000,000,000,000],
			   [000,000,000,000,000,000,000,000,000,000,000,000,000,000],
               [000,000,000,000,000,000,000,000,000,000,000,000,000,000],
			   [000,000,000,000,000,000,000,000,000,000,000,000,000,000],
               [000,000,000,000,000,000,000,000,000,000,000,000,000,000],
               [000,000,000,000,000,000,000,000,000,000,000,000,000,000],
               [000,000,000,000,000,000,000,000,000,000,000,000,000,000], 
			   
			   [400,400,400,400,400,400,400,400,400,400,400,400,400,400],
               [400,000,000,000,000,000,000,000,000,000,000,000,000,400],
			   [400,000,000,000,000,000,000,000,000,000,000,000,000,400],
               [400,000,000,000,000,000,000,000,000,000,000,000,000,400],
			   [400,000,000,000,000,000,000,000,000,000,000,000,000,400],
               [400,000,000,000,000,000,000,000,000,000,000,000,000,400],
			   [400,000,000,000,000,000,000,000,000,000,000,000,000,400],
               [400,000,000,000,000,000,000,000,000,000,000,000,000,400],
               [400,000,000,000,000,000,000,000,000,000,000,000,000,400],
               [400,400,400,400,400,400,400,400,400,400,400,400,400,400] ]
			   
			   
}